XXXXXX
X00X0z
X0X00X
X000XX
X0X00X
XsXXXX