XXXXXX
Xs000X
XXXX0X
X0X00X
X0000z
XXXXXX