XXXXXXX
X000X0z
X0X0X0X
X0X0X0X
X0X0X0X
XsX000X
XXXXXXX