XXXXXXX
XsXX00X
X0X000X
X000XXX
XXX0X0z
X00000X
XXXXXXX