XXXXXXX
z0X000X
X000X0X
XX0000X
s0X0X0X
X00000X
XXXXXXX
