XXXXzXX
XsX000X
X0X0X0X
X000XXX
XXX0X0X
X00000X
XXXXXXX