XXXXXXX
X00X00z
XX0X0XX
X00000X
X0XXX0X
X000s0X
XXXXXXX