XXXXXXX
XsX000X
X0X0X0X
X000X0X
X0XXX0X
X0X000X
XXXzXXX