XXXsXXX
X0X0X0z
X0X0X0X
X00000X
X0X0XXX
X0X000X
XXXXXXX
