XXXXXXXXXXXX
XsX0000X000X
X0X0XX000X0X
X00000XX0XXX
X0XXX0X0000X
X00XX000XX0z
XXXXXXXXXXXX