XXXXXXXXXXXX
X0X000X0000X
X000X0X0XX0X
X0XXX00000XX
X000X0X0X00X
XsX000000X0z
XXXXXXXXXXXX