XXXXXXXXXXXX
X0000000000X
X0XXXXXXXX0z
X0X000000X0X
X0XXXXXX0X0X
s0000000000X
XXXXXXXXXXXX