XXXXXXXXXXXX
XX00000000XX
s00X0XX0X00X
X0XXXXXXXX0X
X00X0XX0X00X
XX00000000XX
XXXXXXXXXzXX
