XXXXXXXXXsXX
X000X0X0000X
X0X0X0X0X00X
X0X0X0X0X00X
X0X0X000X00X
z0X000X0000X
XXXXXXXXXXXX