XXXXXXXXXXXX
X00X0XX0000X
XX0000XXXX0X
z00XX0000X0X
XXXXX0XXXX0X
X0000000000s
XXXXXXXXXXXX
