XXXXXXXXXXXXXXXXX
z00X0X000X0X0000X
XX0X0X0X0000X0X0X
X00X000X0XX000X0s
X0X00X0X0000X0X0X
X000XX000X0X0000X
XXXXXXXXXXXXXXXXX