XXXXXXXXXXXXXXXXX
X000X000X000X000s
X0X000X000X000X0X
X0XXXXXXXXXXXXXXX
X0XX000000X0XX0XX
X0000X0XX0000000z
XXXXXXXXXXXXXXXXX
