XXXXXXXXXXXXXXXXX
X00X0XX0000000X0X
XX0000X0XXXXXXX0X
X00XX0000000X000X
X0X00XX0XX00X0X0X
Xs00X00000X00000z
XXXXXXXXXXXXXXXXX