XXXXzXXXXXXXXXXXX
X0000X000000000XX
XX0XXX0XXX0X0X00X
X0000000000X0XX0X
XXXXXX0XXX0XXX00X
Xs00000X0000000XX
XXXXXXXXXXXXXXXXX