XXXXXXXXXXXXXXXXXXXXXX
XXs0000X0XX000X000XX0X
X00X0X0X0000X0XX0X000X
X0XX0X0X0X0XX000000X0X
X0X0000X0X00XXXXXX0XXX
X00X0X0000X00X0000000X
XXXXXXXXXXXXXXXXXXXXzX